...........GGGG.........
.......GGGGGGGGGG.......
.....GGGGGGGGGGGGGG.....
....GGGGGGGGGGGGGGGG....
...GGGGGGGGGGGGGGGGGG...
..GGGGGGGGGGGGGGGGGGGG..
.GGGGGGGGGGGGGGGGGGGGG.
GGGGGGGGGGGGGGGSSSSGGGGG
GGGGGGGGGGGGGSSWWWSSSGGG
GGGGGGGGGGGSSWWWWWWSSSGG
GGGGGGGGGGGGGSSSWWWWSSGG
GGGGGGGGGGGGGGGGSSSSSGGG
GGGGGGGGGGGGGGGGGGGGGGGG
GGGGGGGGGGGGGGGGGGGGGGGG
GGBBBBBBBGGGGGGGBBBBBBB.
.GBBBBBBBBBBBBBBBBBGGGGG
..BBBBBBBBBBBBBBBBBTGGG..
...GGGGGGGBBBBBBGGGGGGG...
....GGGGGGGGBBBBBBBBBGGG....
.....GGGGGGGGGGBBBBBBBBBB.....
.......GGGGGGGGGG.BBBBBBBBBB
...........GSGG......BBBBBBB
